11111111
1E111P11
111C1111
11111111