1111111111111
1000000000001
1000000000001
111111P000CE1
1111111111111