11111111111111111111111
1E10000000000000000P111
1C101111111111111111111
10001111111111111111111
11111111111111111111111
11111111111111111111111