1111111111111
1000000000001
10000P0000001
1000000000CE1
1111111111111