1111111111111111111
10P0000000C00000001
1000000000C000E0001
1100000000C00000001
1C00000000000000001
1111111111111111111