1111111111111
1PC10000000C1
1000011111111
100011E000001
1111111111111