1111111111111111111
1E1000000000000P001
1C10111111111111111
1000111111111111111
1111111111111111111