11111111111111111111111
1010000000000000000P111
1000000000000000001E111
1100000000000000000C111
1000000000000001001C111
11111111111111111111111