11111111111111111111111
10P0000000C000000011111
1000000000C000E00011111
1100000000C000000011111
1C000000000000000011111
11111111111111111111111