1111111111111
111111P000CE1
1111111111111