1111111111111111111111111111111111111111
10P0000000C00000001111111111111111111111
1000000000C000E0001111111111111111111111
1100000000C00000001111111111111111111111
1C00000000000000001111111111111111111111
1111111111111111111111111111111111111111