1111111111111111111
100001E000C00000P01
1000000000000000001
1111111111011111111
1111111111111111111