1111111111111111111
1E0000C00000000P001
1110000000000000011
1111111110011110011
1111111111111111111